trt##tttt##t
tt##tt#rt#o#
#T#t##t###p#
#tttttttt##t
###rrt#r##r#
#rt##t###tt#
#tr#t#t#tt##