#WWW########
#W#W#W#WWWD#
###W#W#GWG##
#WWW#W##WW##
########WW##
WWWW#WWWW#P#
G####W#G####