#WWWC#######
#W#W#W#WWWD#
###W#W#GWGp#
#WWW#W##WW##
########WW##
WWWW#WWWW###
G####W#G####